
NO textures/ceil.xpm
SO textures/eagle.xpm
WE textures/mossy.xpm
EA textures/greystone.xpm

F 231,145,45
C 80 , 130 , 25

1111111
1S00001
1111111